1111111111
100C000001
1000000001
1011110011
1011010101
1001010111
1001100011
1011010E11
1P10001101
1111111111