1111111111
1000000001
1000000001
1011110011
1011010101
1001010111
1C01100011
1011010011
1P10001101
1111111111