1111111111111111
1C00000000000001
1000010010011001
1000010C100C1C01
1011000110001101
1011000E10100101
1P00000000000001
1111111111111111